1111111111111111111
10P00000000010C0001
1000000000001000001
1000000000001000001
1C0011000000C000001
100011100000C000001
10001C1011100000001
100011101E100100001
1111111111111111111
