11111111111111111111
10000000000000000001
100P0000C00000110001
10000000000000000001
100000000000X0000001
10000001000000100001
100C0001000000100001
100000010000000E0001
10000000000X00000001
11111111111111111111
