1111111111111111111
10P00000000010C0001
100000000000100X001
1000000000001000001
1C0011000000C000001
10000X000000C000001
10000C0000000000001
100011000E000100001
1111111111111111111